1111111111111111111111111111111111
1E0000000000000C00000C00F000000001
1010010100100F00101001000000010101
1010010010101010001001000000010101
1P00000F0C00C000000000000F000000C1
1111111111111111111111111111111111
